##################
#                #
#                #
#                #
#                #
#                #
#                #
#                #
#                #
#    >           #
#                #
#                #
##################
