######
#     
#    #
# <  #
#    #
#######
