###################
#     ##     ##   #
###  ##   #     #  
#    # #####  #####
#  ####   ##   ## #
#    #  ###   # # #
##   ## ###       #
#                 #
###### ############
##      ####      #
#                 #
###################